%%%%%%%%%%%%%%%%%%%%%%%%%%%%%%%%%%%%%%%%%%%%%%%%%%%%%%%%%%%%%%
%.............%...............  ...............%.............%
%%%.%.%%%%%%%.%.%%%%%%%%%%%%%%%%%%%%%%%%%%%%%%.%.%%%%%%%.%.%%%
%...%.%...........%...%.....%.  .%.....%...%...........%.%...%
%.%%%.%.%.%%%.%%%.%.%.%%%%%.%.%%.%.%%%%%.%.%.%%%.%%%.%.%.%%%.%
%...%.%.%.%.%.%o%...%.%...%...%%...%...%.%...%o%.%.%.%.%.%...%
%%%.%.%.%.%.%.%.%.%%%.%.%.%.%.%%.%.%.%.%.%%%.%.%.%.%.%.%.%.%%%
%...%...%...%.%.%.%.%...%...%.  .%...%...%.%.%.%.%...%...%...%
%.%%%%%.%%%.%.%.%.%.%.%%%.%%%%%%%%%%.%%%.%.%.%.%.%.%%%.%%%%%.%
%...%1..%3%.%...%...%...%.....  .....%...%...%...%.%4%..2%...%
%%%.%%%%%.%.%%%%%.%%%%%.%.%.%%%%%%.%.%.%%%%%.%%%%%.%.%%%%%.%%%
%.%.%...%...%.....%...%...%...%%...%...%...%.....%...%...%.%.%
%.%.%.%.%.%%%.%%%%%.%.%%%%%.%%%%%%.%%%%%.%.%%%%%.%%%.%.%.%.%.%
%.....%.....%.%...%.%.....%...  ...%.....%.%...%.%.....%.....%
%%%.%%%.%%%%%.%.%.%.%%%%%.%.%%%%%%.%.%%%%%.%.%.%.%%%%%.%%%.%%%
%.....%.........%.%....o%.....%%.....%o....%.%.........%.....%
%%%%%.%.%%%%%%%%%%%%%%%%%.%%%.  .%%%.%%%%%%%%%%%%%%%%%.%.%%%%%
%...%.%...................%...%%...%...................%.%...%
%.%.%.%.%.%%%%%%%%%%%%%%%%%.%%%%%%.%%%%%%%%%%%%%%%%%.%.%.%.%.%
%.%.....%.....................  .....................%.....%.%
%%%%%%%%%%%%%%%%%%%%%%%%%%%%%%%%%%%%%%%%%%%%%%%%%%%%%%%%%%%%%%
