%%%%%%%%%%%%%%%%%%%%%%%%%%%%%%%%%%%%%%%%%%%%
%   %   %  .......        .......  %   %   %
% % % % % %...%...%%%%%%%%...%...% % % % % %
% % % % % %%%%%.%.        .%.%%%%% % % % % %
% % % % % %.....%.%%%%%%%%.%.....% % % % % %
% % % %o% %.%%%%%.        .%%%%%.% %o% % % %
% % % %o% %.%.%...%%%%%%%%...%.%.% %o% % % %
% % % % % %.......        .......% % % % % %
% % % % % %%%.%%%.%%%%%%%%.%%%.%%% % % % % %
%3% % % % %........%    %........% % % % %4%
%1%   %    ........  %%  ........    %   %2%
%%%%%%%%%%%%%%%%%%%%%%%%%%%%%%%%%%%%%%%%%%%%