%%%%%%%%%%%%%%%%%%%%%%%%%%%%%%%%%%%%%%%%%%%%%%%%%%%%%%%%
%%1       .            ..                  .%%.       o%
%3       .%.          .%%.                  ..         %
%       .%%%.         .%%.      ..                     %
%      .%%%%%.         ..      .%%.                    %
%       .%%%.                  .%%.                 .. %
%        .%.     ..             ..                 .%%.%
%         .     .%%.                               .%%.%
%               .%%.                  ..            .. %
%      ..        ..                  .%%.              %
%     .%%.                           .%%.              %
%     .%%.                 ..         ..               %
%      ..                 .%%.                         %
%                         .%%.                 ..      %
%               ..         ..                 .%%.     %
%              .%%.                           .%%.     %
%              .%%.                  ..        ..      %
% ..            ..                  .%%.               %
%.%%.                               .%%.     .         %
%.%%.                 ..             ..     .%.        %
% ..                 .%%.                  .%%%.       %
%                    .%%.      ..         .%%%%%.      %
%                     ..      .%%.         .%%%.       %
%         ..                  .%%.          .%.       4%
%o       .%%.                  ..            .       2%%
%%%%%%%%%%%%%%%%%%%%%%%%%%%%%%%%%%%%%%%%%%%%%%%%%%%%%%%%